type octile
height 2
width 8
map
@@...@.@
...@...@
