type octile
height 4
width 8
map
@.@.@@@@
........
.@@@@@@.
........
