type octile
height 56
width 56
map
......@..@...@@@.@..@....@..@....@...............@......
..@.....@@..@.................@.........@...@...@.@.@.@.
...@.@........@..........@@..@.....@@......@...@...@....
...............@@....@.@...@............@...@.....@.....
..@....@..@................@.......@@@......@........@..
.....@@..@.@....@.............@.@...@......@.....@@.@...
..@......@....@..@.@.@...@@...@....@...........@@@..@..@
...@@@.@.....@.@....@...@@...@...............@.@....@...
@@.@...@.....@.....@.....@.............@@@..@...@......@
..........@...@@........@...@...@....@.........@........
....@.......@..@..............@.........................
........@.@@..@............@@.@@@...@....@..@..@.@@.@..@
.@..@@@...........@..............@...@..........@@@@....
.@....@...@.....@@.....@....@...@....@.........@..@@@...
.......@...........@...@...........@@...................
.......@@....@....@..@..@..@@.....@.@.......@......@..@@
.......@.........@.@..@.@........@............@........@
...@.............@.............@....@.@......@...@......
..............@@..@@......@..@..................@....@..
@.@....@..@..@.@..@.@@.....................@@...........
.@.......@..........@.@@........@..@@.....@T@......@....
...@..@...@..@...@..@.....@..............@.@.@....@..@..
........@@............@.....@........@@.................
..@....@..............@...................@.....@.....@@
....@.@.......@..@.@...........@.......................@
.@.....@@...........@@.@.@.@.@.@@...@..@.@.......@@.....
...@...@.@@....@.........@@...@.....@...................
@.@@.@....@.......@.............@..@....@...............
.....@................@@....@.@.......@@........@..@....
..@@......@.@.@.....@...@@..@.@.....@...................
@@....@...@................@.............@.......@...@..
...................@.@.........@@.....@.....@.....@....@
@.@@....@.@..@.@..@..@..........@......@.@..@..@...@..@.
@.....@................@.@.@.....@@.@...@..@.....@..@...
.............@..@@...@..@...@@@@.....@..@.......@...@...
@.@.......@...@..@...........@..@.........@....@..@..@.@
T@@@..@..@...............@......@..........@...@...@.@..
T@....@...............@.....@..@..@@......@@............
@......@.@@.@..@@.@@@...@.......@......@.........@....@.
.........@@@........@@...........@.....@....@.@.@....@.@
................@.@..@@.....@...@.@.@..@........@...@...
...@..@..@.........@@.....@....@.........@..@...@@@.....
..@.....@...@............@..@......@....@......@.....@@@
........@.....@@....@.....@.@.....@.....@.@..@..........
...@.........@....@................@.@@...........@.....
..@@@......@@..........@@.................@..@...@@..@..
@..@........@..@.@...@....@.......@......@...@..........
.....@.@.......@.@@......@.....@..@...@......@@@.....@..
..@....@...@@....@.@.@@@........@...@.@.......@.....@...
.............@@.....@@...@.......@@.@....@.@.....@@.@@..
..@.......@......@......@...........@@.@..........@.@@..
.....@....@@..@...@...@.......@......@....@..@@....@...@
..@.......@..@.............@.@@......@@.@...@.........@.
@@...@....@.@..@.@..@..@..@.@.@...@@@...@.@......@..@...
.....@.......@.......@..@..........@T@............@.....
...@....@......@.@...@..@..@.....@@@T@...@.....@..@.@..@
