type octile
height 48
width 48
map
......@..@...@@@.@..@....@..@....@..............
..@.....@@..@.................@.........@...@...
...@.@........@..........@@..@.....@@......@...@
...............@@....@.@...@............@...@...
..@....@..@................@.......@@@......@...
.....@@..@.@....@.............@.@...@......@....
..@......@....@..@.@.@...@@...@....@...........@
...@@@.@.....@.@....@...@@...@...............@.@
@@.@...@.....@.....@.....@.............@@@..@...
..........@...@@........@...@...@....@.........@
....@.......@..@..............@.................
........@.@@..@............@@.@@@...@....@..@..@
.@..@@@...........@..............@...@..........
.@....@...@.....@@.....@....@...@....@.........@
.......@...........@...@...........@@...........
.......@@....@....@..@..@..@@.....@.@.......@...
.......@.........@.@..@.@........@............@.
...@.............@.............@....@.@......@..
..............@@..@@......@..@..................
@.@....@..@..@.@..@.@@.....................@@...
.@.......@..........@.@@........@..@@.....@T@...
...@..@...@..@...@..@.....@..............@.@.@..
........@@............@.....@........@@.........
..@....@..............@...................@.....
....@.@.......@..@.@...........@................
.@.....@@...........@@.@.@.@.@.@@...@..@.@......
...@...@.@@....@.........@@...@.....@...........
@.@@.@....@.......@.............@..@....@.......
.....@................@@....@.@.......@@........
..@@......@.@.@.....@...@@..@.@.....@...........
@@....@...@................@.............@......
...................@.@.........@@.....@.....@...
@.@@....@.@..@.@..@..@..........@......@.@..@..@
@.....@................@.@.@.....@@.@...@..@....
.............@..@@...@..@...@@@@.....@..@.......
@.@.......@...@..@...........@..@.........@....@
T@@@..@..@...............@......@..........@...@
T@....@...............@.....@..@..@@......@@....
@......@.@@.@..@@.@@@...@.......@......@........
.........@@@........@@...........@.....@....@.@.
................@.@..@@.....@...@.@.@..@........
...@..@..@.........@@.....@....@.........@..@...
..@.....@...@............@..@......@....@......@
........@.....@@....@.....@.@.....@.....@.@..@..
...@.........@....@................@.@@.........
..@@@......@@..........@@.................@..@..
@..@........@..@.@...@....@.......@......@...@..
.....@.@.......@.@@......@.....@..@...@......@@@
